username,c3score,c4score,c5score,c6score,c7score,c10score,accepted_number,submission_number,total_score,jichutotal,jichuaccept,jichufail,jichurate,panduantotal,panduanaccept,panduanfail,panduanrate,xunhuantotal,xunhuanaccept,xunhuanfail,xunhuanrate,shuzutotal,shuzuaccept,shuzufail,shuzurate,hanshutotal,hanshuaccept,hanshufail,hanshurate,final,total
161810334,600,1175,775,825,1025,100,0,0,0,7,4,3,0.6 ,28,14,14,0.5 ,64,15,49,0.2 ,45,11,34,0.2 ,5,1,4,0.2 ,68,7
161840232,600,1200,900,900,1600,1200,0,0,0,19,3,16,0.2 ,39,15,24,0.4 ,39,18,21,0.5 ,90,16,74,0.2 ,26,13,13,0.5 ,93,9
161930110,700,1200,850,900,1600,1075,0,0,0,13,4,9,0.3 ,22,16,6,0.7 ,43,18,25,0.4 ,35,16,19,0.5 ,18,9,9,0.5 ,92,9
161940102,900,1200,875,900,1600,1200,0,0,0,13,6,7,0.5 ,19,15,4,0.8 ,34,21,13,0.6 ,35,17,18,0.5 ,21,12,9,0.6 ,98,10
161940103,900,1200,800,775,1300,1200,0,0,0,13,6,7,0.5 ,39,15,24,0.4 ,41,15,26,0.4 ,15,13,2,0.9 ,19,12,7,0.6 ,91,9
161940114,600,1200,900,900,825,975,0,0,0,5,3,2,0.6 ,26,18,8,0.7 ,100,21,79,0.2 ,44,7,37,0.2 ,66,9,57,0.1 ,82,8
161940223,800,1200,600,700,1250,1200,0,0,0,9,6,3,0.7 ,32,16,16,0.5 ,84,17,67,0.2 ,91,12,79,0.1 ,48,12,36,0.3 ,84,8
162010101,900,1200,900,900,1600,1200,0,0,0,11,6,5,0.6 ,35,16,19,0.5 ,50,18,32,0.4 ,58,16,42,0.3 ,39,15,24,0.4 ,98,10
162010102,400,525,675,650,585,1075,0,0,0,9,1,8,0.1 ,36,7,29,0.2 ,30,10,20,0.3 ,26,4,22,0.2 ,25,9,16,0.4 ,60,6
162010103,900,1200,900,900,1600,1175,0,0,0,10,7,3,0.7 ,18,15,3,0.8 ,35,18,17,0.5 ,32,16,16,0.5 ,57,11,46,0.2 ,98,10
162010104,900,1200,900,900,1600,1200,0,0,0,10,6,4,0.6 ,59,16,43,0.3 ,52,19,33,0.4 ,70,19,51,0.3 ,24,12,12,0.5 ,98,10
162010107,600,1200,750,725,1260,1050,0,0,0,4,3,1,0.8 ,17,15,2,0.9 ,31,14,17,0.5 ,30,10,20,0.3 ,13,9,4,0.7 ,82,8
162010108,200,0,400,375,455,1075,0,0,0,8,2,6,0.3 ,15,0,15,0.0 ,23,6,17,0.3 ,18,3,15,0.2 ,13,9,4,0.7 ,37,4
162010109,600,1200,900,900,1600,1100,0,0,0,10,3,7,0.3 ,60,18,42,0.3 ,61,22,39,0.4 ,89,28,61,0.3 ,42,12,30,0.3 ,92,9
162010110,100,0,900,900,1270,1175,0,0,0,10,1,9,0.1 ,15,0,15,0.0 ,46,18,28,0.4 ,81,12,69,0.2 ,44,15,29,0.3 ,65,6
162010112,600,1200,775,800,1010,1000,0,0,0,5,3,2,0.6 ,20,15,5,0.8 ,44,15,29,0.3 ,41,5,36,0.1 ,20,9,11,0.5 ,80,8
162010113,0,0,400,375,655,950,0,0,0,3,0,3,0.0 ,16,0,16,0.0 ,25,6,19,0.2 ,18,5,13,0.3 ,16,7,9,0.4 ,34,4
162010114,0,0,100,200,925,975,0,0,0,3,0,3,0.0 ,22,0,22,0.0 ,24,3,21,0.1 ,19,7,12,0.4 ,14,7,7,0.5 ,29,3
162010115,600,1200,900,900,1410,1100,0,0,0,6,3,3,0.5 ,29,16,13,0.6 ,52,18,34,0.4 ,134,16,118,0.1 ,26,9,17,0.4 ,90,9
162010117,600,1200,900,900,1600,1200,0,0,0,6,3,3,0.5 ,25,15,10,0.6 ,36,19,17,0.5 ,79,16,63,0.2 ,37,12,25,0.3 ,93,9
162010118,600,1200,900,600,1410,1100,0,0,0,8,3,5,0.4 ,41,15,26,0.4 ,39,13,26,0.3 ,41,13,28,0.3 ,19,9,10,0.5 ,84,9
162010119,450,650,650,825,1020,1050,0,0,0,13,2,11,0.2 ,34,8,26,0.2 ,46,13,33,0.3 ,46,10,36,0.2 ,19,8,11,0.4 ,69,7
162010120,600,1200,900,900,1485,1050,0,0,0,10,3,7,0.3 ,36,16,20,0.4 ,58,19,39,0.3 ,34,12,22,0.4 ,24,7,17,0.3 ,90,9
162010121,800,1200,825,900,1035,1000,0,0,0,14,5,9,0.4 ,21,16,5,0.8 ,50,17,33,0.3 ,37,9,28,0.2 ,13,8,5,0.6 ,87,8
162010122,600,1200,900,850,1480,1100,0,0,0,9,3,6,0.3 ,27,15,12,0.6 ,34,17,17,0.5 ,40,12,28,0.3 ,31,9,22,0.3 ,90,9
162010124,900,1200,775,850,1360,950,0,0,0,18,6,12,0.3 ,50,16,34,0.3 ,39,15,24,0.4 ,28,12,16,0.4 ,20,8,12,0.4 ,89,9
162010125,600,1200,875,875,1550,1125,0,0,0,9,3,6,0.3 ,27,15,12,0.6 ,69,20,49,0.3 ,94,18,76,0.2 ,64,12,52,0.2 ,91,9
162010126,900,1200,900,900,1600,1175,0,0,0,15,6,9,0.4 ,38,16,22,0.4 ,37,18,19,0.5 ,46,16,30,0.4 ,25,11,14,0.4 ,98,10
162010127,900,1200,900,775,1555,1175,0,0,0,10,7,3,0.7 ,39,15,24,0.4 ,56,16,40,0.3 ,57,14,43,0.3 ,23,11,12,0.5 ,95,10
162010128,900,1200,900,900,1600,1200,0,0,0,11,6,5,0.6 ,19,15,4,0.8 ,62,21,41,0.3 ,71,17,54,0.2 ,33,17,16,0.5 ,98,10
162010129,900,1200,800,900,1500,550,0,0,0,13,6,7,0.5 ,28,15,13,0.5 ,34,17,17,0.5 ,40,13,27,0.3 ,12,5,7,0.4 ,86,9
162010130,900,900,900,900,1600,1200,0,0,0,29,7,22,0.2 ,65,11,54,0.2 ,32,18,14,0.6 ,52,17,35,0.3 ,12,12,0,1.0 ,94,9
162010133,900,1200,900,775,1335,0,0,0,0,33,6,27,0.2 ,60,15,45,0.3 ,64,17,47,0.3 ,42,11,31,0.3 ,1,0,1,0.0 ,77,8
162010135,600,1200,800,850,1175,950,0,0,0,21,4,17,0.2 ,113,17,96,0.2 ,142,17,125,0.1 ,120,11,109,0.1 ,62,10,52,0.2 ,83,8
162010201,900,1200,900,900,1600,1200,0,0,0,21,8,13,0.4 ,86,16,70,0.2 ,81,20,61,0.3 ,97,19,78,0.2 ,25,13,12,0.5 ,98,10
162010202,900,1200,900,900,1600,1200,0,0,0,45,6,39,0.1 ,36,16,20,0.4 ,71,19,52,0.3 ,89,18,71,0.2 ,30,12,18,0.4 ,98,10
162010203,600,1075,900,800,630,625,0,0,0,8,3,5,0.4 ,23,12,11,0.5 ,43,17,26,0.4 ,30,6,24,0.2 ,13,4,9,0.3 ,72,7
162010204,900,1200,900,900,1600,1200,0,0,0,16,6,10,0.4 ,40,15,25,0.4 ,38,18,20,0.5 ,51,16,35,0.3 ,21,12,9,0.6 ,98,10
162010205,600,1200,650,800,890,975,0,0,0,18,3,15,0.2 ,56,17,39,0.3 ,59,15,44,0.3 ,57,6,51,0.1 ,33,7,26,0.2 ,76,8
162010206,600,1200,725,750,720,1150,0,0,0,12,3,9,0.3 ,22,15,7,0.7 ,54,13,41,0.2 ,30,7,23,0.2 ,15,10,5,0.7 ,77,8
162010207,200,125,100,375,220,875,0,0,0,11,1,10,0.1 ,20,0,20,0.0 ,26,2,24,0.1 ,22,1,21,0.1 ,18,6,12,0.3 ,28,3
162010208,600,1200,750,900,980,1025,0,0,0,7,3,4,0.4 ,25,15,10,0.6 ,76,17,59,0.2 ,30,8,22,0.3 ,19,6,13,0.3 ,82,8
162010209,600,1000,550,625,985,1125,0,0,0,14,3,11,0.2 ,26,12,14,0.5 ,29,10,19,0.3 ,46,7,39,0.2 ,20,10,10,0.5 ,72,7
162010210,400,425,300,450,615,1000,0,0,0,7,2,5,0.3 ,15,6,9,0.4 ,26,5,21,0.2 ,33,4,29,0.1 ,14,6,8,0.4 ,47,5
162010211,400,525,775,700,1155,1050,0,0,0,8,3,5,0.4 ,24,7,17,0.3 ,38,14,24,0.4 ,44,12,32,0.3 ,20,11,9,0.6 ,68,7
162010212,600,1200,800,900,1005,1075,0,0,0,11,3,8,0.3 ,54,15,39,0.3 ,49,15,34,0.3 ,51,8,43,0.2 ,17,9,8,0.5 ,84,8
162010213,600,1125,775,900,1130,1150,0,0,0,23,3,20,0.1 ,77,13,64,0.2 ,67,17,50,0.3 ,122,26,96,0.2 ,51,15,36,0.3 ,84,8
162010214,600,1125,775,600,1125,925,0,0,0,14,3,11,0.2 ,69,14,55,0.2 ,72,12,60,0.2 ,90,10,80,0.1 ,23,7,16,0.3 ,76,8
162010215,900,1200,850,900,1260,1075,0,0,0,16,6,10,0.4 ,39,15,24,0.4 ,55,17,38,0.3 ,52,12,40,0.2 ,26,11,15,0.4 ,92,9
162010216,800,1200,750,675,1360,1175,0,0,0,27,5,22,0.2 ,33,15,18,0.5 ,36,12,24,0.3 ,75,22,53,0.3 ,23,11,12,0.5 ,87,9
162010217,900,1200,900,900,1600,1175,0,0,0,21,6,15,0.3 ,40,15,25,0.4 ,77,20,57,0.3 ,84,26,58,0.3 ,30,11,19,0.4 ,98,10
162010218,600,1100,625,600,795,1025,0,0,0,26,3,23,0.1 ,56,14,42,0.3 ,38,9,29,0.2 ,48,5,43,0.1 ,17,7,10,0.4 ,70,7
162010219,900,1075,550,900,1135,1075,0,0,0,23,6,17,0.3 ,49,13,36,0.3 ,38,14,24,0.4 ,30,9,21,0.3 ,16,8,8,0.5 ,84,8
162010220,600,1150,825,800,1485,1100,0,0,0,76,3,73,0.0 ,64,16,48,0.3 ,99,15,84,0.2 ,94,18,76,0.2 ,66,12,54,0.2 ,87,9
162010221,900,1200,875,700,1410,1075,0,0,0,24,6,18,0.3 ,46,15,31,0.3 ,68,14,54,0.2 ,88,11,77,0.1 ,25,9,16,0.4 ,90,9
162010222,600,1200,675,800,1055,1075,0,0,0,11,3,8,0.3 ,37,17,20,0.5 ,28,13,15,0.5 ,58,8,50,0.1 ,21,10,11,0.5 ,80,8
162010223,800,1200,825,750,1400,1200,0,0,0,21,5,16,0.2 ,45,15,30,0.3 ,56,15,41,0.3 ,55,14,41,0.3 ,38,14,24,0.4 ,90,9
162010224,300,1125,425,675,910,1175,0,0,0,9,2,7,0.2 ,62,11,51,0.2 ,65,9,56,0.1 ,42,10,32,0.2 ,26,12,14,0.5 ,67,7
162010225,600,1200,900,900,1360,1150,0,1,0,32,3,29,0.1 ,98,17,81,0.2 ,42,20,22,0.5 ,62,11,51,0.2 ,31,10,21,0.3 ,90,9
162010226,75,125,200,525,935,1150,0,0,0,16,0,16,0.0 ,20,1,19,0.1 ,29,6,23,0.2 ,34,8,26,0.2 ,16,11,5,0.7 ,42,4
162010228,700,1200,900,900,1110,1150,0,0,0,14,5,9,0.4 ,39,17,22,0.4 ,59,19,40,0.3 ,58,8,50,0.1 ,24,10,14,0.4 ,89,9
162010229,600,1200,900,875,1235,1150,0,0,0,8,3,5,0.4 ,38,15,23,0.4 ,44,19,25,0.4 ,55,11,44,0.2 ,30,11,19,0.4 ,88,9
162010230,0,0,150,575,485,1175,0,0,0,4,0,4,0.0 ,17,0,17,0.0 ,38,6,32,0.2 ,64,6,58,0.1 ,27,11,16,0.4 ,35,4
162010233,100,0,100,225,885,0,0,0,0,6,1,5,0.2 ,17,0,17,0.0 ,25,3,22,0.1 ,26,5,21,0.2 ,2,0,2,0.0 ,17,2
162010234,100,1200,675,500,835,650,0,0,0,8,1,7,0.1 ,38,12,26,0.3 ,40,12,28,0.3 ,22,5,17,0.2 ,26,4,22,0.2 ,58,6
162010301,600,475,675,500,655,1175,0,0,0,12,3,9,0.3 ,31,10,21,0.3 ,37,9,28,0.2 ,34,6,28,0.2 ,16,11,5,0.7 ,61,6
162010302,125,350,500,475,965,900,0,0,0,9,0,9,0.0 ,36,4,32,0.1 ,40,6,34,0.2 ,22,8,14,0.4 ,12,8,4,0.7 ,48,5
162010303,600,1200,900,900,1600,1200,0,0,0,16,3,13,0.2 ,61,15,46,0.3 ,93,22,71,0.2 ,94,18,76,0.2 ,92,15,77,0.2 ,93,9
162010304,0,0,100,100,410,725,0,0,0,3,0,3,0.0 ,18,0,18,0.0 ,18,2,16,0.1 ,18,2,16,0.1 ,10,6,4,0.6 ,18,2
162010305,300,400,700,550,1060,1075,0,0,0,3,1,2,0.3 ,15,6,9,0.4 ,21,11,10,0.5 ,19,8,11,0.4 ,12,9,3,0.8 ,60,6
162010306,900,825,700,775,910,1075,0,0,0,12,6,6,0.5 ,50,14,36,0.3 ,43,13,30,0.3 ,41,7,34,0.2 ,14,10,4,0.7 ,78,8
162010307,200,700,900,800,1010,1150,0,0,0,6,1,5,0.2 ,26,8,18,0.3 ,39,17,22,0.4 ,50,13,37,0.3 ,22,12,10,0.6 ,71,7
162010308,900,1200,900,900,1375,1150,0,0,0,14,6,8,0.4 ,54,15,39,0.3 ,57,19,38,0.3 ,107,13,94,0.1 ,42,10,32,0.2 ,95,9
162010309,900,1200,900,900,1600,1200,0,0,0,21,6,15,0.3 ,59,16,43,0.3 ,52,18,34,0.4 ,84,17,67,0.2 ,49,12,37,0.2 ,98,10
162010310,100,725,200,625,515,1000,0,0,0,4,0,4,0.0 ,29,10,19,0.3 ,25,8,17,0.3 ,28,3,25,0.1 ,15,8,7,0.5 ,46,5
162010311,575,825,500,675,690,1175,0,0,0,15,5,10,0.3 ,58,6,52,0.1 ,62,11,51,0.2 ,51,6,45,0.1 ,12,11,1,0.9 ,66,7
162010312,600,1200,775,825,810,1075,0,0,0,5,3,2,0.6 ,23,15,8,0.7 ,46,18,28,0.4 ,37,8,29,0.2 ,24,11,13,0.5 ,80,8
162010313,600,1200,850,900,1500,1200,0,0,0,7,3,4,0.4 ,44,15,29,0.3 ,50,18,32,0.4 ,89,17,72,0.2 ,88,13,75,0.2 ,91,9
162010314,600,1200,800,850,1430,1200,0,0,0,6,4,2,0.7 ,54,16,38,0.3 ,50,16,34,0.3 ,65,14,51,0.2 ,40,13,27,0.3 ,89,9
162010315,525,1200,825,900,1450,1075,0,0,0,5,3,2,0.6 ,32,15,17,0.5 ,54,17,37,0.3 ,55,14,41,0.3 ,28,8,20,0.3 ,87,9
162010317,500,1175,800,850,1530,1200,0,0,0,6,2,4,0.3 ,28,14,14,0.5 ,62,15,47,0.2 ,104,18,86,0.2 ,60,14,46,0.2 ,88,9
162010318,600,1025,525,700,1250,1125,0,0,0,11,3,8,0.3 ,52,13,39,0.3 ,65,11,54,0.2 ,90,15,75,0.2 ,40,14,26,0.4 ,76,8
162010319,600,1125,800,825,1460,1175,0,1,0,5,3,2,0.6 ,41,13,28,0.3 ,41,13,28,0.3 ,34,13,21,0.4 ,29,12,17,0.4 ,87,9
162010320,600,800,750,800,825,1000,0,0,0,8,3,5,0.4 ,66,8,58,0.1 ,104,22,82,0.2 ,61,10,51,0.2 ,27,9,18,0.3 ,72,7
162010322,900,1200,800,900,1375,1200,0,0,0,19,6,13,0.3 ,55,15,40,0.3 ,66,17,49,0.3 ,177,16,161,0.1 ,50,13,37,0.3 ,94,9
162010323,900,1200,875,900,1500,1200,0,0,0,9,7,2,0.8 ,43,15,28,0.4 ,70,20,50,0.3 ,46,19,27,0.4 ,30,13,17,0.4 ,97,10
162010324,575,1200,725,825,1475,1150,0,0,0,4,3,1,0.8 ,43,15,28,0.4 ,65,13,52,0.2 ,50,14,36,0.3 ,46,10,36,0.2 ,86,9
162010325,350,300,450,725,1205,1050,0,0,0,4,1,3,0.3 ,21,5,16,0.2 ,29,9,20,0.3 ,26,8,18,0.3 ,14,7,7,0.5 ,59,6
162010327,900,1200,900,900,1550,1175,0,0,0,23,6,17,0.3 ,75,19,56,0.3 ,60,18,42,0.3 ,81,17,64,0.2 ,45,11,34,0.2 ,97,10
162010328,600,400,725,900,1500,1200,0,0,0,4,3,1,0.8 ,23,8,15,0.4 ,48,16,32,0.3 ,44,15,29,0.3 ,17,12,5,0.7 ,78,8
162010329,900,1000,500,500,400,575,0,0,0,23,6,17,0.3 ,88,12,76,0.1 ,74,8,66,0.1 ,56,5,51,0.1 ,22,5,17,0.2 ,60,6
162010330,300,275,275,425,1125,1175,0,0,0,7,1,6,0.1 ,18,4,14,0.2 ,27,6,21,0.2 ,23,11,12,0.5 ,12,11,1,0.9 ,50,5
162010332,275,575,750,550,745,1000,0,0,0,10,1,9,0.1 ,14,5,9,0.4 ,36,11,25,0.3 ,43,6,37,0.1 ,17,7,10,0.4 ,58,6
162010333,900,1200,900,900,1600,1200,0,0,0,8,6,2,0.8 ,20,15,5,0.8 ,33,18,15,0.6 ,40,16,24,0.4 ,22,12,10,0.6 ,98,10
162010334,900,1200,900,900,1500,1200,0,0,0,9,7,2,0.8 ,27,15,12,0.6 ,41,19,22,0.5 ,85,16,69,0.2 ,44,15,29,0.3 ,97,10
162010335,925,1200,900,900,1600,1200,4,5,300,9,6,3,0.7 ,22,15,7,0.7 ,21,18,3,0.9 ,39,17,22,0.4 ,22,13,9,0.6 ,99,10
162010336,900,1200,900,900,1600,1200,0,0,0,10,6,4,0.6 ,50,15,35,0.3 ,106,21,85,0.2 ,60,17,43,0.3 ,34,12,22,0.4 ,98,10
162020101,900,1200,900,900,1575,1200,0,0,0,9,6,3,0.7 ,39,15,24,0.4 ,55,19,36,0.4 ,88,15,73,0.2 ,18,12,6,0.7 ,98,10
162020102,600,1200,750,600,600,1000,0,0,0,4,4,0,1.0 ,20,15,5,0.8 ,19,13,6,0.7 ,22,6,16,0.3 ,20,10,10,0.5 ,72,7
162020103,600,1200,900,900,1600,1200,0,0,0,8,4,4,0.5 ,124,16,108,0.1 ,144,21,123,0.2 ,110,16,94,0.2 ,37,13,24,0.4 ,93,9
162020104,600,1200,900,900,1600,1200,0,0,0,17,3,14,0.2 ,70,15,55,0.2 ,95,18,77,0.2 ,148,16,132,0.1 ,36,12,24,0.3 ,93,9
162020105,600,1200,900,900,1600,1200,0,0,0,17,5,12,0.3 ,46,15,31,0.3 ,135,22,113,0.2 ,53,29,24,0.6 ,24,12,12,0.5 ,93,9
162020106,900,1200,900,900,1600,1200,4,14,300,13,6,7,0.5 ,104,17,87,0.2 ,129,25,104,0.2 ,118,19,99,0.2 ,34,13,21,0.4 ,98,10
162020107,600,1200,800,800,1325,1100,0,0,0,3,3,0,1.0 ,39,15,24,0.4 ,42,16,26,0.4 ,30,13,17,0.4 ,13,11,2,0.9 ,85,9
162020108,900,1200,900,850,1405,1100,0,0,0,14,6,8,0.4 ,64,15,49,0.2 ,163,17,146,0.1 ,109,13,96,0.1 ,23,11,12,0.5 ,94,9
162020109,900,1200,900,900,1600,1000,0,0,0,16,6,10,0.4 ,106,15,91,0.1 ,62,18,44,0.3 ,55,16,39,0.3 ,20,10,10,0.5 ,96,10
162020110,800,1200,700,775,1375,1000,0,0,0,29,6,23,0.2 ,68,15,53,0.2 ,52,18,34,0.4 ,69,18,51,0.3 ,15,10,5,0.7 ,86,9
162020111,900,1125,900,900,1600,1175,0,0,0,12,6,6,0.5 ,43,14,29,0.3 ,82,18,64,0.2 ,84,17,67,0.2 ,43,13,30,0.3 ,97,10
162020112,900,1200,850,900,1600,1200,0,0,0,13,6,7,0.5 ,25,15,10,0.6 ,54,23,31,0.4 ,27,17,10,0.6 ,17,14,3,0.8 ,97,10
162020113,900,1200,600,900,1500,1200,0,0,0,11,7,4,0.6 ,26,17,9,0.7 ,38,19,19,0.5 ,40,19,21,0.5 ,17,12,5,0.7 ,92,9
162020114,600,1200,900,900,1500,1200,0,0,0,8,3,5,0.4 ,59,15,44,0.3 ,59,18,41,0.3 ,79,15,64,0.2 ,90,13,77,0.1 ,92,9
162020115,900,1200,900,900,1600,1200,0,0,0,19,6,13,0.3 ,46,16,30,0.4 ,113,21,92,0.2 ,68,20,48,0.3 ,25,12,13,0.5 ,98,10
162020116,900,1025,850,875,1175,275,0,0,0,21,7,14,0.3 ,46,13,33,0.3 ,64,22,42,0.3 ,96,11,85,0.1 ,5,2,3,0.4 ,77,8
162020117,900,1200,900,900,1600,1200,0,0,0,17,6,11,0.4 ,46,15,31,0.3 ,70,22,48,0.3 ,39,16,23,0.4 ,25,14,11,0.6 ,98,10
162020118,900,1200,900,850,1500,1200,0,0,0,11,7,4,0.6 ,37,15,22,0.4 ,77,20,57,0.3 ,132,15,117,0.1 ,26,13,13,0.5 ,96,10
162020119,525,1125,900,900,1425,1150,0,0,0,10,4,6,0.4 ,61,13,48,0.2 ,29,19,10,0.7 ,64,14,50,0.2 ,31,11,20,0.4 ,89,9
162020120,900,1200,900,900,1600,1200,0,0,0,6,6,0,1.0 ,28,15,13,0.5 ,33,18,15,0.6 ,30,17,13,0.6 ,25,13,12,0.5 ,98,10
162020121,900,750,875,900,1100,1100,0,0,0,13,7,6,0.5 ,32,9,23,0.3 ,30,19,11,0.6 ,71,10,61,0.1 ,26,11,15,0.4 ,85,8
162020122,900,1100,800,900,1500,1000,0,0,0,8,6,2,0.8 ,23,14,9,0.6 ,67,17,50,0.3 ,42,16,26,0.4 ,22,9,13,0.4 ,91,9
162020123,900,1100,800,900,1425,1025,0,0,0,7,6,1,0.9 ,23,15,8,0.7 ,36,18,18,0.5 ,46,14,32,0.3 ,31,9,22,0.3 ,91,9
162020124,500,1000,800,900,1480,1100,0,0,0,7,3,4,0.4 ,48,11,37,0.2 ,50,18,32,0.4 ,116,15,101,0.1 ,40,12,28,0.3 ,84,9
162020125,900,1200,900,900,1550,1175,0,0,0,11,6,5,0.6 ,18,15,3,0.8 ,35,18,17,0.5 ,62,15,47,0.2 ,37,12,25,0.3 ,97,10
162020126,900,1200,800,900,1500,1200,0,0,0,18,8,10,0.4 ,37,16,21,0.4 ,68,23,45,0.3 ,65,17,48,0.3 ,45,12,33,0.3 ,95,10
162020127,600,1200,725,800,1500,1200,0,0,0,3,3,0,1.0 ,47,15,32,0.3 ,44,15,29,0.3 ,84,15,69,0.2 ,33,12,21,0.4 ,87,9
162020128,700,1200,825,900,1425,1100,0,0,0,6,4,2,0.7 ,34,15,19,0.4 ,62,23,39,0.4 ,68,15,53,0.2 ,41,11,30,0.3 ,90,9
162020129,900,1200,800,900,1600,1200,0,0,0,12,6,6,0.5 ,41,17,24,0.4 ,76,18,58,0.2 ,108,26,82,0.2 ,40,14,26,0.4 ,96,10
162020130,600,1200,900,900,1600,1200,0,0,0,3,3,0,1.0 ,34,16,18,0.5 ,63,23,40,0.4 ,111,27,84,0.2 ,23,15,8,0.7 ,93,9
162020201,900,1200,900,900,1600,1200,0,0,0,6,6,0,1.0 ,18,15,3,0.8 ,77,19,58,0.3 ,57,18,39,0.3 ,38,14,24,0.4 ,98,10
162020202,900,1200,900,900,1500,1200,0,0,0,7,6,1,0.9 ,21,15,6,0.7 ,41,18,23,0.4 ,25,16,9,0.6 ,18,12,6,0.7 ,97,10
162020204,600,1200,900,900,1300,1200,0,0,0,4,3,1,0.8 ,28,15,13,0.5 ,45,19,26,0.4 ,34,13,21,0.4 ,35,12,23,0.3 ,90,9
162020205,900,1200,800,900,1200,1200,0,0,0,7,6,1,0.9 ,33,15,18,0.5 ,61,19,42,0.3 ,36,15,21,0.4 ,12,12,0,1.0 ,92,9
162020206,900,1200,900,900,1600,1200,0,0,0,9,6,3,0.7 ,48,18,30,0.4 ,125,26,99,0.2 ,70,17,53,0.2 ,33,13,20,0.4 ,98,10
162020207,900,1200,900,900,1600,1200,0,0,0,13,7,6,0.5 ,33,15,18,0.5 ,73,20,53,0.3 ,83,26,57,0.3 ,32,13,19,0.4 ,98,10
162020208,900,1200,825,900,1500,1200,0,0,0,8,6,2,0.8 ,36,15,21,0.4 ,54,21,33,0.4 ,34,15,19,0.4 ,26,13,13,0.5 ,96,10
162020209,900,1200,900,900,1600,1200,0,0,0,18,7,11,0.4 ,38,15,23,0.4 ,63,18,45,0.3 ,34,17,17,0.5 ,19,12,7,0.6 ,98,10
162020210,600,1200,900,900,1600,1200,0,0,0,3,3,0,1.0 ,32,15,17,0.5 ,60,18,42,0.3 ,51,17,34,0.3 ,30,12,18,0.4 ,93,9
162020212,900,1200,900,900,1600,1200,0,0,0,13,6,7,0.5 ,34,15,19,0.4 ,85,19,66,0.2 ,115,16,99,0.1 ,29,12,17,0.4 ,98,10
162020213,900,1200,900,900,1600,1000,0,0,0,20,6,14,0.3 ,42,15,27,0.4 ,54,19,35,0.4 ,89,16,73,0.2 ,27,11,16,0.4 ,96,10
162020214,900,1200,900,900,1600,1200,0,0,0,13,6,7,0.5 ,21,16,5,0.8 ,66,19,47,0.3 ,38,16,22,0.4 ,39,12,27,0.3 ,98,10
162020215,600,1200,900,900,1600,1200,0,0,0,4,3,1,0.8 ,23,18,5,0.8 ,40,18,22,0.5 ,36,16,20,0.4 ,32,14,18,0.4 ,93,9
162020216,900,1200,900,900,1600,300,0,0,0,11,6,5,0.6 ,29,16,13,0.6 ,34,18,16,0.5 ,129,20,109,0.2 ,8,4,4,0.5 ,86,9
162020218,900,1200,900,900,1600,1200,0,0,0,14,7,7,0.5 ,60,15,45,0.3 ,78,18,60,0.2 ,97,18,79,0.2 ,57,12,45,0.2 ,98,10
162020219,900,1200,900,900,1600,1200,0,0,0,28,6,22,0.2 ,76,16,60,0.2 ,88,21,67,0.2 ,66,18,48,0.3 ,59,17,42,0.3 ,98,10
162020220,900,1200,900,900,1600,1200,0,0,0,13,6,7,0.5 ,66,16,50,0.2 ,95,18,77,0.2 ,74,20,54,0.3 ,18,13,5,0.7 ,98,10
162020221,800,1000,775,900,1525,1200,0,0,0,9,6,3,0.7 ,34,12,22,0.4 ,49,17,32,0.4 ,67,15,52,0.2 ,18,12,6,0.7 ,91,9
162020223,900,1200,900,900,1600,1200,0,0,0,12,7,5,0.6 ,33,16,17,0.5 ,41,18,23,0.4 ,107,18,89,0.2 ,30,12,18,0.4 ,98,10
162020224,900,1125,800,750,1400,1200,0,0,0,14,6,8,0.4 ,29,14,15,0.5 ,39,15,24,0.4 ,29,14,15,0.5 ,13,12,1,0.9 ,91,9
162020225,900,1100,800,825,1400,1075,0,0,0,19,6,13,0.3 ,23,14,9,0.6 ,43,16,27,0.4 ,28,14,14,0.5 ,33,10,23,0.3 ,90,9
162020226,900,1200,900,900,1600,1200,0,0,0,21,7,14,0.3 ,91,17,74,0.2 ,70,20,50,0.3 ,88,17,71,0.2 ,20,12,8,0.6 ,98,10
162020227,600,1200,800,850,1560,1175,0,0,0,19,4,15,0.2 ,130,21,109,0.2 ,85,16,69,0.2 ,48,15,33,0.3 ,36,13,23,0.4 ,90,9
162020228,900,1200,900,900,1600,1200,0,0,0,13,7,6,0.5 ,22,16,6,0.7 ,50,23,27,0.5 ,132,20,112,0.2 ,43,12,31,0.3 ,98,10
162020229,900,1200,800,900,1525,1200,0,0,0,38,6,32,0.2 ,131,15,116,0.1 ,89,21,68,0.2 ,42,15,27,0.4 ,13,12,1,0.9 ,96,10
162020230,900,1200,800,825,1600,1200,0,0,0,70,6,64,0.1 ,87,16,71,0.2 ,117,19,98,0.2 ,147,17,130,0.1 ,26,12,14,0.5 ,95,10
162020301,900,1200,850,800,1400,1000,0,0,0,23,6,17,0.3 ,58,15,43,0.3 ,75,15,60,0.2 ,43,13,30,0.3 ,17,10,7,0.6 ,91,9
162020302,900,1200,900,900,1475,1200,0,0,0,31,6,25,0.2 ,104,16,88,0.2 ,145,18,127,0.1 ,161,18,143,0.1 ,62,14,48,0.2 ,97,10
162020303,600,1200,800,900,1600,1100,0,0,0,11,3,8,0.3 ,52,15,37,0.3 ,82,18,64,0.2 ,61,16,45,0.3 ,33,11,22,0.3 ,90,9
162020304,900,1200,900,900,1600,1200,0,0,0,8,6,2,0.8 ,21,15,6,0.7 ,47,19,28,0.4 ,53,18,35,0.3 ,21,12,9,0.6 ,98,10
162020305,900,1100,900,900,1600,1200,3,9,200,20,6,14,0.3 ,37,14,23,0.4 ,57,19,38,0.3 ,49,18,31,0.4 ,25,17,8,0.7 ,97,10
162020306,900,1200,900,900,1600,1200,0,0,0,19,8,11,0.4 ,38,18,20,0.5 ,77,32,45,0.4 ,73,18,55,0.3 ,14,12,2,0.9 ,98,10
162020307,600,1200,725,550,1250,400,0,0,0,9,3,6,0.3 ,26,15,11,0.6 ,43,12,31,0.3 ,25,12,13,0.5 ,4,4,0,1.0 ,69,7
162020308,700,1150,800,900,1550,1050,0,0,0,9,4,5,0.4 ,49,14,35,0.3 ,56,18,38,0.3 ,90,15,75,0.2 ,74,11,63,0.2 ,90,9
162020309,900,1175,825,700,1410,800,0,0,0,16,7,9,0.4 ,37,15,22,0.4 ,43,13,30,0.3 ,46,12,34,0.3 ,19,9,10,0.5 ,85,9
162020310,900,1200,800,875,1300,1175,1,1,100,17,9,8,0.5 ,62,20,42,0.3 ,51,17,34,0.3 ,78,12,66,0.2 ,38,11,27,0.3 ,93,9
162020311,900,800,850,800,950,1200,0,0,0,29,10,19,0.3 ,70,14,56,0.2 ,83,21,62,0.3 ,49,9,40,0.2 ,32,12,20,0.4 ,83,8
162020312,900,1200,900,900,1600,1200,0,0,0,23,6,17,0.3 ,53,15,38,0.3 ,83,22,61,0.3 ,61,17,44,0.3 ,58,12,46,0.2 ,98,10
162020313,900,1200,900,900,1575,1200,0,3,0,9,6,3,0.7 ,47,15,32,0.3 ,100,18,82,0.2 ,90,19,71,0.2 ,40,14,26,0.4 ,98,10
162020314,800,1200,900,900,1575,1175,0,0,0,32,5,27,0.2 ,123,15,108,0.1 ,64,20,44,0.3 ,129,17,112,0.1 ,37,11,26,0.3 ,96,10
162020315,900,1200,900,900,1575,1100,0,0,0,26,6,20,0.2 ,76,15,61,0.2 ,114,18,96,0.2 ,98,16,82,0.2 ,40,11,29,0.3 ,97,10
162020316,850,1025,900,900,1600,1125,0,0,0,15,6,9,0.4 ,38,12,26,0.3 ,63,24,39,0.4 ,138,19,119,0.1 ,41,16,25,0.4 ,94,9
162020317,600,1200,900,900,1600,1175,0,0,0,44,4,40,0.1 ,51,15,36,0.3 ,109,18,91,0.2 ,55,17,38,0.3 ,29,12,17,0.4 ,93,9
162020318,900,1200,900,900,1600,1200,0,0,0,31,9,22,0.3 ,66,15,51,0.2 ,101,26,75,0.3 ,127,26,101,0.2 ,47,15,32,0.3 ,98,10
162020319,875,1100,775,900,1600,1200,0,0,0,16,6,10,0.4 ,79,13,66,0.2 ,119,17,102,0.1 ,61,17,44,0.3 ,72,12,60,0.2 ,94,9
162020320,900,1200,900,900,1600,1200,0,0,0,10,6,4,0.6 ,44,15,29,0.3 ,120,21,99,0.2 ,72,19,53,0.3 ,72,13,59,0.2 ,98,10
162020321,900,1200,900,900,1600,1200,2,3,200,7,6,1,0.9 ,40,16,24,0.4 ,63,20,43,0.3 ,32,16,16,0.5 ,25,14,11,0.6 ,98,10
162020322,900,1200,900,900,1400,1200,0,0,0,9,7,2,0.8 ,62,16,46,0.3 ,70,18,52,0.3 ,48,14,34,0.3 ,23,12,11,0.5 ,96,10
162020323,900,1200,800,900,1600,1200,0,0,0,14,6,8,0.4 ,80,15,65,0.2 ,82,21,61,0.3 ,133,16,117,0.1 ,60,14,46,0.2 ,96,10
162020324,900,1200,800,900,1600,1100,0,0,0,7,6,1,0.9 ,40,16,24,0.4 ,37,19,18,0.5 ,112,18,94,0.2 ,23,11,12,0.5 ,95,10
162020325,900,1200,850,900,1600,1175,0,0,0,7,6,1,0.9 ,23,15,8,0.7 ,60,21,39,0.4 ,55,19,36,0.4 ,31,15,16,0.5 ,97,10
162020326,600,1200,825,900,1600,1175,0,0,0,6,3,3,0.5 ,35,15,20,0.4 ,39,17,22,0.4 ,70,16,54,0.2 ,34,15,19,0.4 ,92,9
162020327,900,1200,800,875,1600,1175,0,0,0,11,6,5,0.6 ,39,15,24,0.4 ,37,16,21,0.4 ,54,17,37,0.3 ,18,11,7,0.6 ,96,10
162020328,900,1200,900,900,1600,1200,0,0,0,33,7,26,0.2 ,168,19,149,0.1 ,135,18,117,0.1 ,163,16,147,0.1 ,47,12,35,0.3 ,98,10
162020329,900,1200,900,900,1600,1175,0,0,0,19,6,13,0.3 ,73,17,56,0.2 ,46,18,28,0.4 ,28,16,12,0.6 ,15,11,4,0.7 ,98,10
162030101,600,1175,775,900,1525,1125,0,0,0,3,3,0,1.0 ,47,14,33,0.3 ,41,15,26,0.4 ,55,18,37,0.3 ,41,10,31,0.2 ,89,9
162030102,600,1200,875,825,1525,1200,0,0,0,4,4,0,1.0 ,19,16,3,0.8 ,41,16,25,0.4 ,44,17,27,0.4 ,24,12,12,0.5 ,91,9
162030103,600,1200,900,700,1600,1200,2,11,200,4,3,1,0.8 ,30,15,15,0.5 ,34,17,17,0.5 ,59,17,42,0.3 ,34,12,22,0.4 ,90,9
162030104,900,1200,900,900,1600,1200,0,0,0,11,6,5,0.6 ,62,16,46,0.3 ,57,18,39,0.3 ,56,16,40,0.3 ,52,13,39,0.3 ,98,10
162030105,900,1200,900,900,1525,1200,0,0,0,8,6,2,0.8 ,50,16,34,0.3 ,98,22,76,0.2 ,139,20,119,0.1 ,31,14,17,0.5 ,98,10
162030106,900,1200,900,900,1600,1200,0,0,0,7,6,1,0.9 ,95,15,80,0.2 ,64,18,46,0.3 ,63,16,47,0.3 ,53,14,39,0.3 ,98,10
162030107,900,1200,900,900,1600,1200,1,2,100,12,9,3,0.8 ,79,15,64,0.2 ,44,19,25,0.4 ,44,17,27,0.4 ,28,13,15,0.5 ,98,10
162030108,900,1200,900,900,1575,1200,0,0,0,11,6,5,0.6 ,21,15,6,0.7 ,67,21,46,0.3 ,37,16,21,0.4 ,22,12,10,0.6 ,98,10
162030109,900,1200,900,900,1600,1200,0,0,0,15,6,9,0.4 ,58,15,43,0.3 ,68,19,49,0.3 ,89,17,72,0.2 ,47,15,32,0.3 ,98,10
162030110,900,1200,900,900,1525,1150,4,11,400,7,6,1,0.9 ,23,17,6,0.7 ,68,23,45,0.3 ,53,18,35,0.3 ,32,10,22,0.3 ,97,10
162030111,600,1200,900,900,1600,1200,21,35,2100,8,4,4,0.5 ,18,16,2,0.9 ,28,19,9,0.7 ,51,18,33,0.4 ,31,12,19,0.4 ,93,9
162030112,900,1200,900,900,1420,1175,0,0,0,29,6,23,0.2 ,75,15,60,0.2 ,63,18,45,0.3 ,193,13,180,0.1 ,43,11,32,0.3 ,96,10
162030113,900,1200,800,900,1600,1200,7,14,700,10,6,4,0.6 ,21,15,6,0.7 ,49,17,32,0.4 ,93,16,77,0.2 ,26,12,14,0.5 ,96,10
162030114,600,1200,875,900,1575,1200,1,1,100,3,3,0,1.0 ,21,15,6,0.7 ,98,20,78,0.2 ,53,15,38,0.3 ,41,14,27,0.3 ,93,9
162030115,600,1200,900,900,1375,1200,1,2,100,3,3,0,1.0 ,42,16,26,0.4 ,95,19,76,0.2 ,68,12,56,0.2 ,29,12,17,0.4 ,91,9
162030116,900,1200,800,900,1415,1150,0,0,0,13,7,6,0.5 ,47,16,31,0.3 ,58,17,41,0.3 ,41,13,28,0.3 ,44,11,33,0.3 ,94,9
162030117,600,1150,875,800,1325,1075,0,0,0,5,3,2,0.6 ,36,14,22,0.4 ,30,17,13,0.6 ,40,13,27,0.3 ,24,11,13,0.5 ,86,9
162030118,900,1200,850,900,1000,1075,0,0,0,15,6,9,0.4 ,102,20,82,0.2 ,106,18,88,0.2 ,90,13,77,0.1 ,51,10,41,0.2 ,89,9
162030119,500,1200,825,625,635,525,0,3,0,15,3,12,0.2 ,95,14,81,0.2 ,102,13,89,0.1 ,48,5,43,0.1 ,39,5,34,0.1 ,66,6
162030120,400,625,750,625,525,875,0,0,0,3,1,2,0.3 ,48,7,41,0.2 ,64,13,51,0.2 ,16,5,11,0.3 ,11,8,3,0.7 ,58,6
162030121,600,700,900,800,325,1075,0,0,0,3,3,0,1.0 ,22,8,14,0.4 ,51,17,34,0.3 ,44,4,40,0.1 ,14,10,4,0.7 ,70,6
162030124,900,1200,900,900,1600,1200,0,0,0,22,7,15,0.3 ,51,16,35,0.3 ,69,19,50,0.3 ,71,17,54,0.2 ,40,15,25,0.4 ,98,10
162030125,900,1200,825,900,820,1200,0,0,0,14,9,5,0.6 ,67,19,48,0.3 ,106,21,85,0.2 ,93,8,85,0.1 ,27,12,15,0.4 ,89,9
162030126,900,1200,800,800,900,1200,0,1,0,10,7,3,0.7 ,62,16,46,0.3 ,82,16,66,0.2 ,67,9,58,0.1 ,30,12,18,0.4 ,87,9
162030127,900,1200,800,825,1475,1175,0,0,0,9,6,3,0.7 ,36,15,21,0.4 ,49,18,31,0.4 ,67,14,53,0.2 ,36,11,25,0.3 ,93,9
162030128,900,1200,900,900,1550,1200,0,0,0,8,7,1,0.9 ,33,15,18,0.5 ,51,19,32,0.4 ,70,15,55,0.2 ,28,12,16,0.4 ,98,10
162030130,900,1200,900,900,1600,1200,0,0,0,9,6,3,0.7 ,37,19,18,0.5 ,71,18,53,0.3 ,79,16,63,0.2 ,25,12,13,0.5 ,98,10
162030131,900,1200,900,900,1600,1200,0,0,0,9,7,2,0.8 ,116,24,92,0.2 ,61,24,37,0.4 ,64,22,42,0.3 ,37,14,23,0.4 ,98,10
162030201,600,1200,900,900,1400,1200,0,0,0,5,5,0,1.0 ,81,15,66,0.2 ,100,20,80,0.2 ,38,14,24,0.4 ,21,12,9,0.6 ,91,9
162030202,900,1200,900,900,1600,1200,0,0,0,9,7,2,0.8 ,50,15,35,0.3 ,46,18,28,0.4 ,80,16,64,0.2 ,100,15,85,0.2 ,98,10
162030203,900,1200,900,900,1600,1200,0,0,0,11,6,5,0.6 ,52,18,34,0.4 ,52,19,33,0.4 ,56,17,39,0.3 ,30,12,18,0.4 ,98,10
162030204,900,1200,900,900,1600,1200,0,0,0,7,6,1,0.9 ,36,15,21,0.4 ,46,18,28,0.4 ,77,16,61,0.2 ,22,12,10,0.6 ,98,10
162030205,900,1200,900,900,1600,1200,0,0,0,11,6,5,0.6 ,30,15,15,0.5 ,25,18,7,0.7 ,67,16,51,0.2 ,23,12,11,0.5 ,98,10
162030206,900,1200,900,900,1525,1200,0,0,0,8,6,2,0.8 ,59,15,44,0.3 ,82,23,59,0.3 ,160,18,142,0.1 ,35,12,23,0.3 ,98,10
162030207,900,1200,900,900,1500,1200,3,11,325,10,6,4,0.6 ,39,15,24,0.4 ,58,18,40,0.3 ,133,15,118,0.1 ,45,12,33,0.3 ,97,10
162030208,900,1200,900,825,1600,1200,0,0,0,27,6,21,0.2 ,32,15,17,0.5 ,38,17,21,0.5 ,39,17,22,0.4 ,18,12,6,0.7 ,97,10
162030209,900,1200,900,900,1600,1200,0,0,0,9,6,3,0.7 ,30,15,15,0.5 ,48,18,30,0.4 ,63,25,38,0.4 ,41,13,28,0.3 ,98,10
162030210,500,300,900,900,575,1200,0,0,0,8,3,5,0.4 ,57,5,52,0.1 ,46,18,28,0.4 ,51,5,46,0.1 ,80,12,68,0.2 ,68,6
162030211,900,1200,900,900,1600,1200,3,4,300,11,6,5,0.6 ,51,18,33,0.4 ,43,20,23,0.5 ,149,17,132,0.1 ,37,14,23,0.4 ,98,10
162030212,900,1200,900,900,1380,1200,0,0,0,7,6,1,0.9 ,91,18,73,0.2 ,136,25,111,0.2 ,107,15,92,0.1 ,92,13,79,0.1 ,96,10
162030213,900,1200,900,900,1600,1200,0,0,0,8,6,2,0.8 ,68,15,53,0.2 ,107,19,88,0.2 ,142,18,124,0.1 ,48,12,36,0.3 ,98,10
162030214,600,1200,900,825,1500,1175,0,0,0,5,3,2,0.6 ,158,15,143,0.1 ,273,17,256,0.1 ,214,13,201,0.1 ,40,12,28,0.3 ,91,9
162030215,900,1200,800,875,1430,1200,0,0,0,12,6,6,0.5 ,59,15,44,0.3 ,93,17,76,0.2 ,199,19,180,0.1 ,79,15,64,0.2 ,94,9
162030216,600,1200,900,900,1450,1200,0,0,0,3,3,0,1.0 ,40,15,25,0.4 ,54,22,32,0.4 ,76,18,58,0.2 ,21,12,9,0.6 ,92,9
162030217,600,1200,900,775,1500,1025,0,0,0,3,3,0,1.0 ,41,15,26,0.4 ,51,16,35,0.3 ,39,15,24,0.4 ,37,9,28,0.2 ,88,9
162030218,900,1200,900,900,1500,1200,0,0,0,7,7,0,1.0 ,39,15,24,0.4 ,62,18,44,0.3 ,78,15,63,0.2 ,36,12,24,0.3 ,97,10
162030219,600,1200,900,900,1500,1200,0,0,0,8,3,5,0.4 ,46,15,31,0.3 ,162,21,141,0.1 ,75,16,59,0.2 ,78,12,66,0.2 ,92,9
162030220,900,1200,900,900,1600,1200,0,0,0,9,9,0,1.0 ,73,21,52,0.3 ,77,21,56,0.3 ,97,23,74,0.2 ,25,14,11,0.6 ,98,10
162030221,900,1200,900,900,1375,1200,0,0,0,8,6,2,0.8 ,37,17,20,0.5 ,56,28,28,0.5 ,149,30,119,0.2 ,39,16,23,0.4 ,96,10
162030222,900,1200,900,900,1600,1200,4,9,300,26,7,19,0.3 ,36,15,21,0.4 ,110,19,91,0.2 ,110,19,91,0.2 ,41,14,27,0.3 ,98,10
162030223,900,1200,900,900,1600,1200,0,0,0,7,6,1,0.9 ,17,15,2,0.9 ,34,18,16,0.5 ,25,17,8,0.7 ,25,12,13,0.5 ,98,10
162030224,900,1200,900,900,1600,1200,2,17,200,31,8,23,0.3 ,58,15,43,0.3 ,93,18,75,0.2 ,61,17,44,0.3 ,26,12,14,0.5 ,98,10
162030225,900,1200,900,900,1335,1200,0,0,0,6,6,0,1.0 ,53,18,35,0.3 ,63,18,45,0.3 ,44,11,33,0.3 ,32,12,20,0.4 ,96,9
162030226,700,1200,900,900,1600,1200,0,0,0,5,4,1,0.8 ,99,16,83,0.2 ,38,19,19,0.5 ,55,16,39,0.3 ,21,12,9,0.6 ,95,10
162030227,900,1200,900,900,1600,1200,0,0,0,10,8,2,0.8 ,79,15,64,0.2 ,62,18,44,0.3 ,84,18,66,0.2 ,37,12,25,0.3 ,98,10
162030228,1000,1200,900,900,1600,1200,5,10,500,10,7,3,0.7 ,16,15,1,0.9 ,42,19,23,0.5 ,49,29,20,0.6 ,33,13,20,0.4 ,100,10
162030229,1000,1200,900,900,1600,1200,0,0,0,9,7,2,0.8 ,33,15,18,0.5 ,60,28,32,0.5 ,68,17,51,0.3 ,23,14,9,0.6 ,100,10
162030230,900,1200,900,900,1600,1200,2,4,200,7,6,1,0.9 ,18,15,3,0.8 ,68,18,50,0.3 ,74,16,58,0.2 ,29,14,15,0.5 ,98,10
162030301,900,1200,850,900,1475,1200,0,0,0,9,6,3,0.7 ,108,15,93,0.1 ,119,17,102,0.1 ,124,14,110,0.1 ,47,12,35,0.3 ,96,10
162030302,900,1200,900,900,1600,1200,0,0,0,15,6,9,0.4 ,36,15,21,0.4 ,86,18,68,0.2 ,82,16,66,0.2 ,24,12,12,0.5 ,98,10
162030303,600,1200,900,900,1500,1150,0,0,0,4,3,1,0.8 ,25,15,10,0.6 ,65,18,47,0.3 ,80,20,60,0.3 ,87,11,76,0.1 ,92,9
162030304,900,1200,400,900,1400,975,0,0,0,18,6,12,0.3 ,68,15,53,0.2 ,62,13,49,0.2 ,48,18,30,0.4 ,34,9,25,0.3 ,84,8
162030305,900,1200,800,900,1500,1200,0,0,0,43,7,36,0.2 ,176,23,153,0.1 ,213,26,187,0.1 ,248,33,215,0.1 ,147,35,112,0.2 ,95,10
162030306,900,1200,900,900,1440,1200,0,0,0,14,9,5,0.6 ,79,16,63,0.2 ,105,27,78,0.3 ,138,15,123,0.1 ,98,19,79,0.2 ,97,10
162030307,900,1200,900,850,1225,1200,0,0,0,7,6,1,0.9 ,42,15,27,0.4 ,45,19,26,0.4 ,58,11,47,0.2 ,32,13,19,0.4 ,94,9
162030308,600,1075,800,825,1225,1000,0,0,0,3,3,0,1.0 ,31,13,18,0.4 ,56,18,38,0.3 ,37,13,24,0.4 ,32,8,24,0.3 ,82,8
162030310,575,975,800,750,1255,1100,0,0,0,4,4,0,1.0 ,62,9,53,0.2 ,84,15,69,0.2 ,66,10,56,0.2 ,26,10,16,0.4 ,80,8
162030311,900,1200,800,850,1500,1150,0,0,0,48,6,42,0.1 ,56,16,40,0.3 ,54,17,37,0.3 ,35,15,20,0.4 ,38,11,27,0.3 ,94,9
162030312,900,1200,900,900,1600,1175,2,4,200,7,6,1,0.9 ,31,15,16,0.5 ,57,20,37,0.4 ,48,16,32,0.3 ,28,11,17,0.4 ,98,10
162030313,600,1200,900,900,1550,1125,0,6,0,3,3,0,1.0 ,23,15,8,0.7 ,42,18,24,0.4 ,41,15,26,0.4 ,24,12,12,0.5 ,92,9
162030314,600,1200,800,850,1300,800,2,2,200,3,3,0,1.0 ,22,15,7,0.7 ,30,16,14,0.5 ,48,14,34,0.3 ,14,8,6,0.6 ,82,8
162030315,900,1200,900,900,1600,1200,8,11,800,6,6,0,1.0 ,16,15,1,0.9 ,34,22,12,0.7 ,45,19,26,0.4 ,32,12,20,0.4 ,98,10
162030316,900,1200,900,900,1450,1200,0,0,0,22,6,16,0.3 ,116,16,100,0.1 ,79,28,51,0.4 ,80,15,65,0.2 ,59,13,46,0.2 ,97,10
162030317,900,1200,900,900,1575,1200,0,0,0,9,6,3,0.7 ,59,16,43,0.3 ,78,18,60,0.2 ,48,16,32,0.3 ,18,12,6,0.7 ,98,10
162030318,900,1200,900,900,1600,1200,0,0,0,31,6,25,0.2 ,93,16,77,0.2 ,69,23,46,0.3 ,72,16,56,0.2 ,23,12,11,0.5 ,98,10
162030319,600,1200,900,900,1575,1200,0,0,0,4,3,1,0.8 ,42,17,25,0.4 ,66,20,46,0.3 ,64,18,46,0.3 ,25,14,11,0.6 ,93,9
162030320,900,1175,700,800,1500,700,2,2,100,8,6,2,0.8 ,33,14,19,0.4 ,31,15,16,0.5 ,62,15,47,0.2 ,16,8,8,0.5 ,84,8
162030321,900,1200,900,900,1600,1200,14,16,1300,15,10,5,0.7 ,27,23,4,0.9 ,38,20,18,0.5 ,72,17,55,0.2 ,30,12,18,0.4 ,98,10
162030322,600,1075,800,800,660,1000,0,0,0,5,3,2,0.6 ,56,13,43,0.2 ,45,16,29,0.4 ,40,5,35,0.1 ,12,10,2,0.8 ,75,7
162030323,900,1200,800,900,1375,1200,0,0,0,16,6,10,0.4 ,46,23,23,0.5 ,39,19,20,0.5 ,49,15,34,0.3 ,29,15,14,0.5 ,94,9
162030324,900,1200,900,900,1600,1200,2,3,200,7,6,1,0.9 ,37,15,22,0.4 ,48,19,29,0.4 ,69,16,53,0.2 ,33,12,21,0.4 ,98,10
162030325,1000,1200,900,900,1600,1200,9,29,900,14,8,6,0.6 ,37,28,9,0.8 ,37,24,13,0.7 ,77,26,51,0.3 ,22,13,9,0.6 ,100,10
162030326,900,1200,900,900,1600,1200,9,26,900,9,9,0,1.0 ,64,24,40,0.4 ,84,40,44,0.5 ,115,28,87,0.2 ,37,27,10,0.7 ,98,10
162030327,900,1200,900,850,1600,1100,0,0,0,9,7,2,0.8 ,33,15,18,0.5 ,50,17,33,0.3 ,120,16,104,0.1 ,39,10,29,0.3 ,96,10
162030328,900,1200,775,900,1600,1200,0,0,0,10,6,4,0.6 ,32,15,17,0.5 ,51,16,35,0.3 ,54,17,37,0.3 ,26,15,11,0.6 ,96,10
162030329,900,1200,700,900,1600,1200,0,0,0,8,6,2,0.8 ,27,15,12,0.6 ,61,16,45,0.3 ,58,16,42,0.3 ,20,12,8,0.6 ,95,10
162030330,900,1200,800,825,1600,1200,0,0,0,9,6,3,0.7 ,21,16,5,0.8 ,41,17,24,0.4 ,73,18,55,0.3 ,34,12,22,0.4 ,95,10
162040101,900,1200,900,900,1600,1200,0,0,0,26,8,18,0.3 ,71,16,55,0.2 ,35,19,16,0.5 ,58,16,42,0.3 ,48,12,36,0.3 ,98,10
162040102,900,1200,900,900,1600,1200,0,0,0,7,6,1,0.9 ,53,16,37,0.3 ,62,18,44,0.3 ,35,16,19,0.5 ,37,12,25,0.3 ,98,10
162040104,900,1200,600,100,600,800,0,0,0,9,6,3,0.7 ,35,16,19,0.5 ,39,7,32,0.2 ,39,6,33,0.2 ,8,8,0,1.0 ,62,6
162040105,900,1200,900,825,1075,1050,0,0,0,18,6,12,0.3 ,149,15,134,0.1 ,160,17,143,0.1 ,101,8,93,0.1 ,50,9,41,0.2 ,89,9
162040106,900,1200,900,900,1600,1200,0,0,0,16,6,10,0.4 ,56,15,41,0.3 ,50,19,31,0.4 ,50,17,33,0.3 ,26,12,14,0.5 ,98,10
162040107,900,1025,900,425,1600,1200,0,0,0,17,6,11,0.4 ,35,13,22,0.4 ,48,13,35,0.3 ,23,18,5,0.8 ,39,15,24,0.4 ,87,9
162040108,900,1150,900,900,1390,1200,0,0,0,22,6,16,0.3 ,73,14,59,0.2 ,61,18,43,0.3 ,77,14,63,0.2 ,45,12,33,0.3 ,95,9
162040109,900,1200,900,900,1500,975,0,0,0,24,6,18,0.3 ,55,19,36,0.4 ,69,21,48,0.3 ,56,15,41,0.3 ,24,9,15,0.4 ,94,9
162040110,900,1200,900,900,1600,1200,0,0,0,17,6,11,0.4 ,52,15,37,0.3 ,51,18,33,0.4 ,44,16,28,0.4 ,30,13,17,0.4 ,98,10
162040111,600,1200,850,900,1600,1200,0,0,0,15,3,12,0.2 ,34,18,16,0.5 ,44,19,25,0.4 ,56,20,36,0.4 ,45,13,32,0.3 ,92,9
162040112,900,1200,900,900,1600,1200,0,0,0,7,6,1,0.9 ,26,15,11,0.6 ,35,18,17,0.5 ,53,19,34,0.4 ,22,12,10,0.6 ,98,10
162040113,600,1200,850,900,1600,1200,0,4,0,10,4,6,0.4 ,47,15,32,0.3 ,69,21,48,0.3 ,102,19,83,0.2 ,40,13,27,0.3 ,92,9
162040114,900,1200,900,900,1500,1200,0,0,0,21,6,15,0.3 ,82,21,61,0.3 ,110,24,86,0.2 ,46,22,24,0.5 ,29,19,10,0.7 ,97,10
162040115,900,1200,900,900,1600,1200,0,0,0,31,6,25,0.2 ,53,15,38,0.3 ,100,23,77,0.2 ,68,21,47,0.3 ,21,12,9,0.6 ,98,10
162040116,900,1200,900,900,1600,1200,0,0,0,12,6,6,0.5 ,17,15,2,0.9 ,35,18,17,0.5 ,117,18,99,0.2 ,39,12,27,0.3 ,98,10
162040117,900,1200,900,900,1600,1200,0,0,0,32,11,21,0.3 ,79,16,63,0.2 ,80,19,61,0.2 ,90,16,74,0.2 ,49,12,37,0.2 ,98,10
162040118,900,1200,900,900,1600,1200,0,0,0,10,6,4,0.6 ,97,15,82,0.2 ,68,28,40,0.4 ,79,26,53,0.3 ,22,15,7,0.7 ,98,10
162040120,900,1200,900,850,1375,1100,0,0,0,21,6,15,0.3 ,32,16,16,0.5 ,57,18,39,0.3 ,41,15,26,0.4 ,19,11,8,0.6 ,94,9
162040121,900,1200,900,900,1600,1200,0,0,0,8,6,2,0.8 ,31,16,15,0.5 ,62,26,36,0.4 ,49,25,24,0.5 ,30,18,12,0.6 ,98,10
162040122,900,1100,700,700,1335,1000,3,10,200,18,7,11,0.4 ,38,14,24,0.4 ,46,15,31,0.3 ,91,13,78,0.1 ,28,11,17,0.4 ,84,8
162040123,900,1025,850,900,850,875,0,0,0,8,6,2,0.8 ,58,13,45,0.2 ,65,18,47,0.3 ,57,8,49,0.1 ,33,8,25,0.2 ,83,8
162040124,900,1200,900,900,1600,300,0,0,0,13,6,7,0.5 ,48,15,33,0.3 ,111,23,88,0.2 ,103,16,87,0.2 ,4,3,1,0.8 ,86,9
162040125,900,1200,900,900,1600,1200,0,0,0,17,7,10,0.4 ,67,16,51,0.2 ,41,18,23,0.4 ,32,16,16,0.5 ,21,12,9,0.6 ,98,10
162040126,900,1200,900,900,1600,1200,0,0,0,7,6,1,0.9 ,28,15,13,0.5 ,41,18,23,0.4 ,41,16,25,0.4 ,25,12,13,0.5 ,98,10
162040127,600,1200,900,900,1560,1200,0,0,0,7,4,3,0.6 ,46,16,30,0.4 ,91,20,71,0.2 ,51,15,36,0.3 ,26,12,14,0.5 ,93,9
162040128,600,1200,900,900,1600,1200,0,0,0,4,3,1,0.8 ,47,16,31,0.3 ,57,19,38,0.3 ,98,16,82,0.2 ,68,13,55,0.2 ,93,9
162040130,900,1200,900,900,1500,1200,0,0,0,13,7,6,0.5 ,48,16,32,0.3 ,71,21,50,0.3 ,69,16,53,0.2 ,27,12,15,0.4 ,97,10
162040131,900,1100,800,900,1200,875,0,0,0,16,6,10,0.4 ,32,14,18,0.4 ,35,17,18,0.5 ,85,12,73,0.1 ,26,7,19,0.3 ,86,8
162040132,900,1200,700,900,1360,700,0,0,0,9,6,3,0.7 ,34,16,18,0.5 ,67,18,49,0.3 ,67,14,53,0.2 ,25,7,18,0.3 ,85,8
162040201,900,1200,900,900,1600,1200,0,0,0,30,6,24,0.2 ,51,15,36,0.3 ,106,18,88,0.2 ,79,17,62,0.2 ,70,13,57,0.2 ,98,10
162040202,900,1000,900,825,1380,1100,0,0,0,71,7,64,0.1 ,124,14,110,0.1 ,162,18,144,0.1 ,192,13,179,0.1 ,150,11,139,0.1 ,90,9
162040203,900,1200,775,850,1450,1175,0,0,0,16,6,10,0.4 ,27,16,11,0.6 ,30,16,14,0.5 ,53,14,39,0.3 ,24,11,13,0.5 ,93,9
162040204,900,875,850,875,1385,1200,0,0,0,11,7,4,0.6 ,58,14,44,0.2 ,91,19,72,0.2 ,83,16,67,0.2 ,54,16,38,0.3 ,90,9
162040205,600,1200,900,900,1600,1200,0,0,0,8,6,2,0.8 ,78,16,62,0.2 ,84,20,64,0.2 ,87,16,71,0.2 ,71,13,58,0.2 ,93,9
162040206,600,1200,900,900,1575,1200,2,3,100,3,3,0,1.0 ,20,16,4,0.8 ,60,25,35,0.4 ,49,17,32,0.4 ,26,13,13,0.5 ,93,9
162040207,600,1200,900,900,1560,1050,3,5,200,33,3,30,0.1 ,46,15,31,0.3 ,58,18,40,0.3 ,24,15,9,0.6 ,33,10,23,0.3 ,91,9
162040208,600,1200,900,900,1600,1200,0,0,0,5,3,2,0.6 ,82,17,65,0.2 ,144,21,123,0.2 ,92,16,76,0.2 ,58,13,45,0.2 ,93,9
162040209,600,1100,875,900,1400,800,1,1,100,8,3,5,0.4 ,55,15,40,0.3 ,66,17,49,0.3 ,20,14,6,0.7 ,19,8,11,0.4 ,84,8
162040210,900,1200,900,900,1500,1200,0,0,0,15,6,9,0.4 ,50,16,34,0.3 ,64,18,46,0.3 ,61,21,40,0.3 ,44,15,29,0.3 ,97,10
162040211,600,1200,900,900,1600,1200,0,0,0,5,4,1,0.8 ,28,16,12,0.6 ,58,22,36,0.4 ,61,17,44,0.3 ,23,12,11,0.5 ,93,9
162040212,900,1200,900,900,1600,1200,0,0,0,31,9,22,0.3 ,123,20,103,0.2 ,144,25,119,0.2 ,208,24,184,0.1 ,72,15,57,0.2 ,98,10
162040213,900,1200,900,900,1600,1200,0,0,0,19,7,12,0.4 ,46,15,31,0.3 ,46,23,23,0.5 ,61,18,43,0.3 ,26,13,13,0.5 ,98,10
162040214,900,1200,900,900,1600,1200,0,0,0,37,6,31,0.2 ,55,16,39,0.3 ,99,20,79,0.2 ,62,19,43,0.3 ,58,14,44,0.2 ,98,10
162040215,600,1200,900,900,1600,1200,0,0,0,4,3,1,0.8 ,17,15,2,0.9 ,52,21,31,0.4 ,51,17,34,0.3 ,26,12,14,0.5 ,93,9
162040216,400,775,800,900,1485,1200,0,0,0,10,1,9,0.1 ,103,10,93,0.1 ,132,17,115,0.1 ,80,13,67,0.2 ,29,12,17,0.4 ,81,8
162040217,900,1200,900,900,1600,1200,0,0,0,70,6,64,0.1 ,129,25,104,0.2 ,127,30,97,0.2 ,111,19,92,0.2 ,68,27,41,0.4 ,98,10
162040218,900,1200,900,800,1600,1200,0,0,0,34,6,28,0.2 ,97,15,82,0.2 ,121,20,101,0.2 ,79,16,63,0.2 ,73,12,61,0.2 ,96,10
162040219,900,1200,900,900,1600,1200,0,0,0,49,6,43,0.1 ,108,17,91,0.2 ,129,18,111,0.1 ,35,17,18,0.5 ,74,14,60,0.2 ,98,10
162040220,900,1200,900,900,1600,1200,0,0,0,13,7,6,0.5 ,30,15,15,0.5 ,54,18,36,0.3 ,75,16,59,0.2 ,31,12,19,0.4 ,98,10
162040221,900,1200,900,900,1600,1200,0,0,0,8,6,2,0.8 ,34,16,18,0.5 ,76,18,58,0.2 ,92,17,75,0.2 ,22,12,10,0.6 ,98,10
162040222,900,1200,800,850,1600,1200,0,0,0,10,6,4,0.6 ,61,16,45,0.3 ,72,16,56,0.2 ,36,16,20,0.4 ,23,12,11,0.5 ,96,10
162040223,900,1200,900,900,1600,1200,0,0,0,7,6,1,0.9 ,35,15,20,0.4 ,39,21,18,0.5 ,74,18,56,0.2 ,35,13,22,0.4 ,98,10
162040224,900,1200,900,900,1600,1200,0,0,0,14,6,8,0.4 ,56,15,41,0.3 ,40,19,21,0.5 ,53,18,35,0.3 ,37,12,25,0.3 ,98,10
162040225,900,1200,900,900,1600,1200,0,0,0,22,6,16,0.3 ,35,15,20,0.4 ,80,19,61,0.2 ,81,16,65,0.2 ,46,13,33,0.3 ,98,10
162040226,900,1200,900,900,1600,1200,0,0,0,13,6,7,0.5 ,35,15,20,0.4 ,110,24,86,0.2 ,53,24,29,0.5 ,38,21,17,0.6 ,98,10
162040227,900,1200,900,900,1600,1200,0,0,0,9,6,3,0.7 ,50,15,35,0.3 ,101,22,79,0.2 ,136,22,114,0.2 ,26,13,13,0.5 ,98,10
162040228,600,975,800,750,1455,1175,0,0,0,13,3,10,0.2 ,96,16,80,0.2 ,80,16,64,0.2 ,70,14,56,0.2 ,50,11,39,0.2 ,84,8
162040229,900,1200,900,800,1100,900,0,0,0,28,6,22,0.2 ,53,15,38,0.3 ,69,18,51,0.3 ,50,11,39,0.2 ,18,9,9,0.5 ,87,9
162040230,900,1175,900,900,1600,1175,0,0,0,12,6,6,0.5 ,39,15,24,0.4 ,83,19,64,0.2 ,136,16,120,0.1 ,69,11,58,0.2 ,98,10
162040231,600,1200,800,850,1015,1000,0,0,0,5,3,2,0.6 ,45,15,30,0.3 ,51,19,32,0.4 ,44,8,36,0.2 ,26,7,19,0.3 ,82,8
162050101,900,1200,900,900,1600,1025,0,0,0,10,6,4,0.6 ,64,15,49,0.2 ,109,19,90,0.2 ,119,17,102,0.1 ,37,10,27,0.3 ,96,10
162050102,900,1200,700,800,1125,1175,0,0,0,49,7,42,0.1 ,211,15,196,0.1 ,191,15,176,0.1 ,209,11,198,0.1 ,173,11,162,0.1 ,87,9
162050103,900,1200,800,900,1400,850,0,0,0,31,7,24,0.2 ,84,17,67,0.2 ,151,19,132,0.1 ,92,15,77,0.2 ,30,9,21,0.3 ,90,9
162050104,900,1175,800,900,1600,1200,0,0,0,10,6,4,0.6 ,42,14,28,0.3 ,18,17,1,0.9 ,25,16,9,0.6 ,16,12,4,0.8 ,96,10
162050105,900,1200,900,900,1600,1200,0,0,0,13,8,5,0.6 ,52,16,36,0.3 ,22,18,4,0.8 ,23,17,6,0.7 ,22,12,10,0.6 ,98,10
162050106,900,1025,850,900,1600,1200,0,0,0,30,6,24,0.2 ,145,17,128,0.1 ,87,20,67,0.2 ,31,17,14,0.6 ,24,12,12,0.5 ,95,10
162050107,900,1200,900,900,1600,1200,0,0,0,31,6,25,0.2 ,138,23,115,0.2 ,136,25,111,0.2 ,88,16,72,0.2 ,24,12,12,0.5 ,98,10
162050108,900,1200,900,900,1600,1200,0,0,0,25,6,19,0.2 ,25,16,9,0.6 ,19,18,1,1.0 ,22,17,5,0.8 ,15,12,3,0.8 ,98,10
162050109,600,1200,900,900,1600,500,0,0,0,12,4,8,0.3 ,30,15,15,0.5 ,41,20,21,0.5 ,36,17,19,0.5 ,14,5,9,0.4 ,84,8
162050110,900,1200,900,900,1600,1200,0,0,0,20,6,14,0.3 ,75,18,57,0.2 ,73,23,50,0.3 ,39,21,18,0.5 ,28,17,11,0.6 ,98,10
162050111,900,1200,900,900,1600,1200,0,0,0,45,8,37,0.2 ,110,15,95,0.1 ,137,20,117,0.2 ,168,19,149,0.1 ,69,12,57,0.2 ,98,10
162050112,900,1200,900,900,100,1200,0,0,0,24,6,18,0.3 ,74,17,57,0.2 ,44,19,25,0.4 ,3,1,2,0.3 ,21,13,8,0.6 ,83,8
162050113,900,1200,900,900,1600,1200,0,0,0,39,8,31,0.2 ,62,16,46,0.3 ,128,23,105,0.2 ,144,19,125,0.1 ,54,14,40,0.3 ,98,10
162050114,900,1200,900,900,1600,1200,0,0,0,39,6,33,0.2 ,55,15,40,0.3 ,52,22,30,0.4 ,70,20,50,0.3 ,28,15,13,0.5 ,98,10
162050115,900,1200,900,900,1600,1200,0,0,0,34,11,23,0.3 ,79,17,62,0.2 ,31,19,12,0.6 ,62,18,44,0.3 ,21,12,9,0.6 ,98,10
162050116,900,1200,900,900,1500,1000,0,0,0,28,7,21,0.3 ,32,15,17,0.5 ,58,18,40,0.3 ,83,16,67,0.2 ,20,10,10,0.5 ,95,9
162050117,600,1200,900,900,1500,975,0,0,0,13,4,9,0.3 ,56,19,37,0.3 ,97,19,78,0.2 ,111,16,95,0.1 ,53,9,44,0.2 ,89,9
162050118,900,1200,900,900,1600,1200,0,0,0,45,6,39,0.1 ,71,16,55,0.2 ,36,18,18,0.5 ,52,17,35,0.3 ,28,13,15,0.5 ,98,10
162050119,900,1200,900,900,1600,1200,0,0,0,31,7,24,0.2 ,99,18,81,0.2 ,153,19,134,0.1 ,41,20,21,0.5 ,38,12,26,0.3 ,98,10
162050120,900,1200,900,900,1600,1125,0,0,0,9,6,3,0.7 ,62,15,47,0.2 ,47,19,28,0.4 ,61,17,44,0.3 ,51,12,39,0.2 ,97,10
162050121,900,1200,900,900,1525,1200,0,0,0,36,9,27,0.3 ,88,25,63,0.3 ,106,33,73,0.3 ,91,26,65,0.3 ,54,12,42,0.2 ,98,10
162050122,900,1200,775,750,1295,1075,0,0,0,18,7,11,0.4 ,89,15,74,0.2 ,89,17,72,0.2 ,122,14,108,0.1 ,34,12,22,0.4 ,88,9
162050123,900,1200,900,900,1600,200,0,0,0,39,7,32,0.2 ,154,15,139,0.1 ,212,18,194,0.1 ,106,16,90,0.2 ,4,2,2,0.5 ,84,8
162050124,900,1200,900,900,1600,1200,0,0,0,17,6,11,0.4 ,62,19,43,0.3 ,71,21,50,0.3 ,42,16,26,0.4 ,19,12,7,0.6 ,98,10
162050126,500,1200,900,900,1600,1200,0,0,0,9,2,7,0.2 ,87,19,68,0.2 ,123,23,100,0.2 ,159,18,141,0.1 ,60,12,48,0.2 ,92,9
162050127,900,1200,900,900,1600,1100,0,0,0,24,7,17,0.3 ,144,21,123,0.2 ,152,23,129,0.2 ,67,30,37,0.5 ,81,12,69,0.2 ,97,10
162050128,900,1200,900,900,1600,1200,0,0,0,30,6,24,0.2 ,153,18,135,0.1 ,242,22,220,0.1 ,92,17,75,0.2 ,111,13,98,0.1 ,98,10
162050129,900,1200,750,900,1395,1025,0,0,0,30,7,23,0.2 ,73,19,54,0.3 ,143,24,119,0.2 ,59,14,45,0.2 ,53,11,42,0.2 ,91,9
162050201,600,1200,900,900,1600,1200,0,0,0,9,3,6,0.3 ,91,16,75,0.2 ,19,18,1,1.0 ,20,16,4,0.8 ,28,12,16,0.4 ,93,9
162050202,600,1200,825,800,1300,1200,0,0,0,8,4,4,0.5 ,72,21,51,0.3 ,51,21,30,0.4 ,55,13,42,0.2 ,25,14,11,0.6 ,87,9
162050203,825,1200,900,900,1600,1200,0,0,0,20,6,14,0.3 ,33,14,19,0.4 ,25,19,6,0.8 ,20,16,4,0.8 ,15,13,2,0.9 ,97,10
162050205,900,1200,900,900,1600,1200,0,0,0,22,6,16,0.3 ,30,15,15,0.5 ,62,18,44,0.3 ,21,16,5,0.8 ,12,12,0,1.0 ,98,10
162050206,900,1200,800,800,1480,1100,0,0,0,13,6,7,0.5 ,110,17,93,0.2 ,89,20,69,0.2 ,78,15,63,0.2 ,26,11,15,0.4 ,92,9
162050207,600,1200,700,900,1400,1200,1,6,100,10,3,7,0.3 ,64,18,46,0.3 ,60,16,44,0.3 ,96,14,82,0.2 ,91,13,78,0.1 ,88,9
162050208,900,1200,900,900,1600,1200,0,4,105,12,6,6,0.5 ,58,15,43,0.3 ,61,20,41,0.3 ,75,18,57,0.2 ,34,12,22,0.4 ,98,10
162050209,600,1200,800,800,1400,1100,1,13,100,38,4,34,0.1 ,130,15,115,0.1 ,49,16,33,0.3 ,72,15,57,0.2 ,66,12,54,0.2 ,86,9
162050210,600,1200,775,425,1500,100,2,2,200,6,3,3,0.5 ,33,15,18,0.5 ,78,11,67,0.1 ,40,15,25,0.4 ,11,1,10,0.1 ,66,7
162050211,600,1200,875,850,1500,875,0,0,0,14,4,10,0.3 ,29,16,13,0.6 ,88,16,72,0.2 ,56,17,39,0.3 ,19,8,11,0.4 ,86,9
162050213,600,1200,775,0,1400,1200,0,0,0,12,5,7,0.4 ,24,17,7,0.7 ,60,10,50,0.2 ,29,14,15,0.5 ,25,12,13,0.5 ,72,8
162050214,900,1000,900,900,1250,1200,0,0,0,26,7,19,0.3 ,44,14,30,0.3 ,94,19,75,0.2 ,65,13,52,0.2 ,45,14,31,0.3 ,92,9
162050216,900,1000,900,900,1415,1200,0,0,0,12,6,6,0.5 ,40,14,26,0.4 ,53,20,33,0.4 ,54,15,39,0.3 ,24,14,10,0.6 ,94,9
162050217,900,1200,900,900,1600,500,0,0,0,6,6,0,1.0 ,26,15,11,0.6 ,87,23,64,0.3 ,21,16,5,0.8 ,11,5,6,0.5 ,89,9
162050218,900,1000,725,900,1600,1200,0,6,0,69,6,63,0.1 ,209,11,198,0.1 ,130,17,113,0.1 ,122,23,99,0.2 ,89,14,75,0.2 ,92,9
162050219,800,1200,600,750,1575,1100,0,0,0,35,7,28,0.2 ,101,17,84,0.2 ,131,13,118,0.1 ,68,16,52,0.2 ,25,12,13,0.5 ,87,9
162050221,900,225,650,650,200,0,0,0,0,91,8,83,0.1 ,78,6,72,0.1 ,71,10,61,0.1 ,34,2,32,0.1 ,16,0,16,0.0 ,44,4
162050222,600,1200,900,900,1600,1200,0,0,0,30,8,22,0.3 ,110,30,80,0.3 ,130,39,91,0.3 ,51,36,15,0.7 ,26,23,3,0.9 ,93,9
162050223,600,1200,850,900,1500,1200,4,5,300,11,3,8,0.3 ,38,15,23,0.4 ,40,17,23,0.4 ,33,19,14,0.6 ,17,13,4,0.8 ,91,9
162050224,700,1200,900,900,1600,1200,0,0,0,6,4,2,0.7 ,56,15,41,0.3 ,100,23,77,0.2 ,76,18,58,0.2 ,30,13,17,0.4 ,95,10
162050225,900,1200,900,900,1600,1200,0,0,0,11,7,4,0.6 ,36,15,21,0.4 ,52,19,33,0.4 ,49,18,31,0.4 ,26,13,13,0.5 ,98,10
162050226,900,1200,900,900,1600,1200,0,0,0,7,7,0,1.0 ,35,16,19,0.5 ,113,19,94,0.2 ,138,23,115,0.2 ,46,18,28,0.4 ,98,10
162050227,900,1200,900,900,1600,1200,0,0,0,22,7,15,0.3 ,75,15,60,0.2 ,91,22,69,0.2 ,30,22,8,0.7 ,18,12,6,0.7 ,98,10
162050229,900,1200,900,900,1125,1200,0,0,0,8,6,2,0.8 ,19,15,4,0.8 ,31,18,13,0.6 ,33,10,23,0.3 ,30,12,18,0.4 ,93,9
162050230,900,1200,900,900,1600,1200,0,0,0,29,6,23,0.2 ,68,15,53,0.2 ,41,21,20,0.5 ,45,17,28,0.4 ,27,12,15,0.4 ,98,10
